1 0
14 17
64 64 64 64 64 64 64 64 64 64 64 64 64 64 64 64 64 64
32 32 32 32 32 64 64 64 32 32 32 32 32 32 32 32 32 64
64 64 32 64 32 64 64 64 32 64 32 64 64 32 64 64 64 64
64 64 32 64 32 64 64 64 32 64 32 64 64 32 32 32 32 64
64 64 32 64 32 32 32 32 32 64 32 64 64 32 64 64 32 64
64 64 32 64 64 32 64 64 64 64 32 32 64 32 64 64 32 64
64 64 32 64 64 32 64 64 32 64 64 32 64 32 64 64 32 64
64 64 32 64 64 32 64 64 32 64 64 32 64 32 64 32 32 64
64 32 32 64 64 32 64 64 32 64 64 32 64 32 64 64 64 64
64 64 32 64 64 32 64 64 32 64 64 32 64 32 32 32 32 64
64 64 32 64 64 32 32 32 32 64 64 32 64 64 64 64 64 64
64 64 32 64 64 64 64 64 32 64 64 32 64 64 64 32 64 64
64 64 32 32 32 64 64 64 32 64 64 32 64 64 64 32 64 64
64 64 32 64 64 64 32 32 32 64 64 32 64 64 64 32 64 64
64 64 32 64 64 64 32 64 64 64 64 32 32 32 64 32 32 32
64 64 32 32 32 64 32 64 64 64 64 64 64 64 64 32 64 64
64 64 64 64 32 64 32 32 32 32 32 32 32 32 32 32 64 64
64 64 64 64 32 64 64 64 64 64 32 64 64 64 64 32 64 64
64 32 32 32 32 64 64 64 64 64 32 64 64 64 64 32 64 64
64 64 64 64 64 64 64 64 64 64 64 64 64 64 64 64 64 64